▤▤▤▤▤▤▤▤▤▤▤▤▤▤▤▤▤▤▤▤▤▤▤▤▤▤▤▤▤▤▤▤▤▤▤▤▤▤▤▤▤▤▤▤▤▤▤▤▤▤▤▤▤▤▤▤▤▤▤▤▤▤▤▤▤▤▤▤▤▤▤▤▤▤▤▤▤▤▤▤
▤♣♣♣♣♣      ♣♣♣▤             ▤      ♣♣   ♣♣     ▤   ▤▤    ▤      ▤   ▤   ▤    ▤▤
▤♣ ♣▤▤▤▤                     ▤         ♣♣                 ▤                    ▤
▤♣♣♣▤▤▤▤                             ♣♣                      ▤▤▤▤▤▤▤▤▤▤▤▤▤▤▤▤▤▤▤
▤                            ▤             ♣              ▤                    ▤
▤♣♣♣                         ▤             ♣                                   ▤
▤♣       ▤▤▤▤▤▤▤▤            ▤                            ▤                    ▤
▤ ♣♣♣♣   ▤      ▤            ▤        ♣     ♣♣            ▤                    ▤
▤  ♣     ▤      ▤            ▤                            ▤     ♣♣♣♣♣♣♣♣♣♣♣♣♣♣♣▤
▤        ▤      ▤▤▤▤▤▤▤▤▤▤▤  ▤          ♣      ♣          ▤       ♣♣♣♣♣♣♣♣♣♣♣♣♣▤
▤   ☺♣   ▤                   ▤                            ▤                    ▤
▤        ▤                   ▤                            ▤ ♣ ♣                ▤
▤        ▤▤▤▤▤▤▤▤▤▤▤▤▤▤▤▤▤▤▤▤▤                     ♣ ♣    ▤                    ▤
▤                            ▤           ♣♣     ♣         ▤            ♣♣      ▤
▤                  ♣♣♣       ▤                            ▤      ♣           ♣ ▤
▤                   ♣        ▤                            ▤                    ▤
▤  ▤▤▤▤▤▤▤▤▤▤▤▤▤▤▤▤▤▤▤▤▤▤▤   ▤                    ♣♣      ▤                    ▤
▤  ▤          ♣♣         ▤   ▤                 ♣           ▤      ♣     ♣      ▤
▤  ▤                     ▤   ▤                            ▤                    ▤
▤  ▤              ♣♣♣    ▤   ▤                            ▤▤▤▤▤▤▤▤▤▤▤▤▤▤▤▤▤▤▤▤ ▤
▤  ▤                     ▤▤▤▤▤       ♣          ♣         ▤       ♣♣   ♣♣♣♣♣♣♣♣▤
▤  ▤  ♣♣♣                    ▤                            ▤      ♣♣♣♣    ♣♣♣ ♣♣▤
▤  ▤                         ▤                            ▤            ♣♣♣♣♣   ▤
▤  ▤  ▤▤▤▤▤▤▤▤▤▤▤▤▤▤▤▤▤▤▤▤▤▤▤▤            ♣♣♣♣♣♣          ▤   ♣♣♣♣♣♣       ♣♣♣♣▤
▤  ▤                         ▤             ♣♣♣♣           ▤           ♣♣♣    ♣♣▤
▤  ▤       ♣♣                ▤                      ♣♣    ▤♣♣♣♣           ♣♣  ♣▤
▤  ▤                ♣♣♣      ▤                            ▤♣♣♣♣   ♣♣♣♣♣  ♣♣♣♣♣♣▤
▤  ▤                         ▤     ♣♣        ♣♣           ▤♣      ♣♣♣     ♣♣♣♣♣▤
▤                            ▤                            ▤♣♣    ♣♣♣♣♣♣     ♣♣♣▤
▤▤▤▤▤▤▤▤▤▤▤▤▤▤▤▤▤▤▤▤▤▤▤▤▤▤▤▤▤▤▤▤▤▤▤▤▤▤▤▤▤▤▤▤▤▤▤▤▤▤▤▤▤▤▤▤▤▤▤▤▤▤▤▤▤▤▤▤▤▤▤▤▤▤▤▤▤▤▤▤